**********************
*11111111111111111111*
*10000000000000500001*
*10005000000000000001*
*10005000000000005001*
*10500033333333330001*
*1000003A222222230001*
*1000003227222d230001*
*1000003777222t230001*
*1000003222222y230001*
*10000032222222230001*
*10500032htu222230001*
*10050032222222230001*
*10000033333333330001*
*10000000000000000001*
*10000etx000005000001*
*10050000000050000001*
*10000000000000000001*
*10000500000000000501*
*100dtu000rtw00000001*
*11111111111111111111*