**********************
*11111111111111111111*
*10000000000000000001*
*10000500000000000001*
*10000000000000005001*
*10050000333333330001*
*10050000300000030501*
*1000000030t000030001*
*1000333330000x030001*
*10003222200000030001*
*100032e220400A030001*
*10003222200000030001*
*10003333333333330001*
*10000000000000000001*
*10000r00d00000000001*
*10000t00t00000000001*
*10000w00u00000000001*
*10500000000000000501*
*10005000000000050001*
*10000000000000000001*
*11111111111111111111*