**********************
*11111111111111111111*
*10000hty0700gty00001*
*10000000007050000001*
*1005000007000a000501*
*10500000007000005001*
*10000000070000000001*
*10000500007000000001*
*10000500070000005001*
*10000000007050000001*
*1d000000070000803001*
*1t050000007000000001*
*1u005000070itv000001*
*100000A0007000050001*
*10000000070000005001*
*1000rtw0007050000001*
*10000000070000066661*
*10050000007000060001*
*10500000070000560001*
*100000000070000600x1*
*11111111111111111111*