**********************
*11111111111111111111*
*10000000000hty000001*
*100000000000022200d1*
*100022200000023200t1*
*100023200000022200u1*
*10002220000000000001*
*10000000000000000001*
*12200000222000000001*
*132000002A2000000001*
*12200000222000000001*
*100000000000777x7771*
*10000000000075222551*
*1000r000000075232551*
*1000t000000075222551*
*1000w00000007555B551*
*12220000000075555551*
*12320000000075555551*
*12220000stz075555551*
*10000000000075555551*
*11111111111111111111*