**********************
*11111111111111111111*
*15230000etx000000001*
*12230000000000000001*
*13330000000033333001*
*10000000000035553001*
*10000000000035453001*
*10000000000035553001*
*13333300000033333001*
*13222300000000000001*
*132A2000000000000001*
*13222300000000000001*
*133333008880000000d1*
*100000008a80000000t1*
*100i00008880000000u1*
*100t0000000000000001*
*100v0000000006660001*
*10000000000006860001*
*10000000000006660001*
*1000rtw000000000gty1*
*11111111111111111111*