**********************
*11111111111111111111*
*100dtu0000000hty0001*
*10500000000000000001*
*10000005000000000001*
*10000000333000005001*
*100B0000343000B00001*
*10000000323e0000B001*
*10000000373t00050001*
*1B005000373x00000001*
*100000003733000000B1*
*10000000373000005001*
*10500B00323000050001*
*10000000000050000001*
*10000A00000000000001*
*10000000500000000501*
*1000rtw005000stz0001*
*15002220000002220001*
*10002220000002220001*
*10002220000002220001*
*11111111111111111111*