**********************
*11111111111111111111*
*1itu8005007000050001*
*10008000007000000501*
*1hty8050337333333301*
*10008000307003222301*
*1etx8000307000242301*
*18888000307003222301*
*10000000307003333301*
*10003333307333000001*
*10003222307777777771*
*100032A2000003000001*
*10003222300003000001*
*10003333300003000001*
*10000rtw30dtu3005001*
*10500000300003000001*
*10000000333333000001*
*10050000000000500001*
*10050000000000050001*
*10000005000000000001*
*11111111111111111111*