**********************
*11111111111111111111*
*12223000000000032221*
*12423000000050032421*
*1222300at00000032221*
*13333000000000033331*
*10000500000000005001*
*10500000333300000001*
*10000000322350000001*
*100000503243050000d1*
*100000003023000000t1*
*100000009999000000u1*
*100500A0999900000501*
*1050rtw0333300000001*
*10000000jtu300000001*
*10000000000000050001*
*13333000000000033331*
*12223005000000032221*
*12423000000500032421*
*1222300etx0000032221*
*11111111111111111111*