**********************
*11111111111111111111*
*10000000000000000001*
*10000000000000000001*
*10000000000000000001*
*10000000000000000001*
*10000dtu0000itv00001*
*10000000000000000001*
*10003333333333330001*
*10002222282222220001*
*100022A2282224220001*
*10002222282222220001*
*10003333333333330001*
*10000000000000000001*
*10000rtw0000etx00001*
*10000000000000000001*
*10000000000000000001*
*10000000000000000001*
*10000000000000000001*
*10000000000000000001*
*11111111111111111111*