**********************
*11111111111111111111*
*1rd30000000000000001*
*1tt30000000000050001*
*1wu30000000gty000001*
*13330033333333000001*
*1000003222itv3000501*
*10050032222223000001*
*10500032A28823000001*
*10000032222223000001*
*10033333666633333001*
*10030000000000003001*
*10030000000000003001*
*10030000000000003001*
*10036660000000003001*
*100366600000etx03001*
*10034660000000003001*
*10033333333333333001*
*10000500000000000001*
*10000000050050000001*
*11111111111111111111*