**********************
*11111111111111111111*
*1BBBBBBBBBBBBBBBBBB1*
*1BBBBBBBBxBBBBBBBBB1*
*1BBBBBBBBBBBBBBBBBB1*
*1BBBBBBBBBBBBBBBBBB1*
*1BBBBBBBBBBBBBBBBBB1*
*1BBBBBBBBBBBBBBBBBB1*
*1BBBBBBBBBBBBBBBBBB1*
*1BBBBBBBBBBBBBBBBBB1*
*1BBBBBBBBBBBBBBBBBB1*
*1BBBBBBBBBBBBBBBBBB1*
*1BBBBBBBBBABBBBBBBB1*
*1BBBBBBBBBBBBBBBBBB1*
*1BBBaBBsBBBBBBBBBBB1*
*1BBBtBBtBBBBBBBBBBB1*
*1BBBrtwBBBBBBBBBBBB1*
*1BBBBBBBBBBBBBBBBBB1*
*1BBBBBBBBBBBBBBBBBB1*
*1BBBBBBBBBBBBBBBBBB1*
*11111111111111111111*