**********************
*11111111111111111111*
*10000dtu000000500001*
*10080000080000050001*
*10500008000000000001*
*10000000000000080001*
*10000000000000000001*
*10333330000777770001*
*10322230000755570001*
*10322280000754570001*
*1032A230000755570001*
*10333330000777770001*
*10000000000000000001*
*10000000000000050001*
*103rtw30000000080001*
*100000000000000000e1*
*10500000itv0000000t1*
*150000000000000000x1*
*10000000000000500001*
*10hty000000000000001*
*11111111111111111111*