**********************
*11111111111111111111*
*10000000000000000001*
*10000050000000005001*
*100000000000etx00001*
*10050000000333330001*
*10000000000322230001*
*10000000000324230501*
*10000000000322230001*
*10000333333333330001*
*10000300000000030001*
*1000030dtu0000030001*
*10000300000000030001*
*10000300000000030001*
*100003A0000000030001*
*15000300000000030001*
*10000300000000030001*
*10000333333333330001*
*100000rtw00000005001*
*10000000000000000001*
*11111111111111111111*