**********************
*11111111111111111111*
*100000000ftu00000001*
*10000000000000000001*
*10000000000000000001*
*10000000000000000001*
*10000000000000000001*
*10000000000000000001*
*10333333333333330001*
*10300000050050030001*
*1030rtw0005004030001*
*10300000050050530001*
*10300000005500030001*
*10300A00500505030001*
*1030000050e0x0530001*
*10300000500500030001*
*10300050050000030001*
*10333333333333330001*
*10000000000000000001*
*10000000000000000001*
*11111111111111111111*